[
    ["A1","A2","E1","E2","G1","G2","J1","J2"],
    ["A1","A2","E1","E2","G1","G2","J1","J2"],
    ["A1","A2","E1","E2","G1","G2","K1","K2"],
    ["A1","A2","E1","E2","G1","G2","K1","K2"],
    ["A1","A2","E1","E2","H1","H2","K1","K2"],
    ["A1","A2","E1","E2","H1","H2","K1","K2"],
    ["C1","C2","F1","F2","H1","H2","K1","K2"]
]